111111111111111111111111
1P100000100000000000N001
101011101011110111111101
10101000101N000100000001
101010111010111101111111
101010001010100101000001
101010101010100101011101
10101C10101000010100C1N1
100011101011110101111101
10001N001000010100000001
111110101111010101111101
1000001000000101C001C001
101111111101110111111101
100C0C0000001C0000C1E001
111111111111111111111111
