1111111111111
1C10000000011
1000000000011
1001P100001E1
1111111111111