1111111111111
1C010000000C1
1000C10110N01
1P0011E000001
1111111111111