11111111111111111
10000N00000000001
100000C000000NN01
10N00000000000001
1000E00P0C0000001
10000N0000000N001
100000N0001000001
100000000C0000001
11111111111111111